border_size=1
usage=map

Xu          ,Xu          , Xu          , Xu          , Xu          , Xu          , Xu          , Xu          , Xu          , Xu          , Xu          , Xu          , Xu          , Xu          , Xu          , Xu          , Xu          , Xu          , Xu          , Wo          , Wo          , Wo          
Xu          ,Xu          , Xu          , Xu          , Xu          , Xu          , Xu          , Xu          , Xu          , Xu          , Xu          , Xu          , Xu          , Xu          , Xu          , Xu          , Xu          , Xu          , Xu          , Wo          , Wo          , Wo          
Xu          ,Xu          , Xu          , Xu          , Xu          , Xu          , Uu          , Uu^Vud      , Uu          , Xu          , Uu          , Xu          , Xu          , Xu          , Xu          , Xu          , Xu          , Xu          , Wo          , Wo          , Wo          , Wo          
Xu          ,Xu          , Xu          , Xu          , Xu          , Xu          , Uu          , Uu          , Ww          , Uu          , Ww          , Uu          , Uu          , Xu          , Xu          , Xu          , Xu          , Wo          , Wo          , Wo          , Xu          , Xu          
Xu          ,Xu          , Xu          , Xu          , Uu          , Uu          , Ww          , Ww          , Wo          , Wo          , Wo          , Ww          , Uu          , Xu          , Xu          , Xu          , Xu          , Wo          , Wo          , Xu          , Xu          , Xu          
Xu          ,Xu          , Xu          , Xu          , Uu          , Wo          , Wo          , Wo          , Wo          , Wo          , Wo          , Wo          , Ww          , Uu          , Xu          , Xu          , Wo          , Wo          , Wo          , Xu          , Xu          , Xu          
Xu          ,Xu          , Xu          , Uu          , Uu          , Wo          , Wo          , Wo          , Wo          , Wo          , Xu          , Ww          , Ww          , Uu          , Xu          , Xu          , Wo          , Wo          , Wo          , Xu          , Xu          , Xu          
Xu          ,Xu          , Uh          , Uh          , Xu          , Wo          , Wo          , Wo          , Xu          , Xu          , Xu          , Xu          , Uu          , Uu          , Xu          , Xu          , Wo          , Wo          , Wo          , Wo          , Xu          , Xu          
Xu          ,Xu          , Uh          , Xu          , Xu          , Wo          , Wo          , Wo          , Xu          , Xu          , Xu          , Uu          , Xu          , Xu          , Xu          , Xu          , Wo          , Wo          , Wo          , Wo          , Xu          , Xu          
Xu          ,Xu          , Uu          , Xu          , Xu          , Wo          , Wo          , Wo          , Wo          , Xu          , Xu          , Xu          , Xu          , Xu          , Wo          , Wo          , Wo          , Wo          , Xu          , Xu          , Xu          , Xu          
Xu          ,Xu          , Uu          , Xu          , Xu          , Xu          , Xu          , Wo          , Wo          , Wo          , Wo          , Xu          , Wo          , Wo          , Wo          , Wo          , Wo          , Xu          , Xu          , Xu          , Xu          , Xu          
Xu          ,Xu          , Uu          , Xu          , Wo          , Xu          , Wo          , Wo          , Wo          , Wo          , Wo          , Wo          , Wo          , Wo          , Wo          , Wo          , Wo          , Wo          , Xu          , Xu          , Xu          , Xu          
Xu          ,Xu          , Xu          , Uu          , Ww          , Wo          , Wo          , Wo          , Xu          , Xu          , Xu          , Wo          , Wo          , Wo          , Wo          , Wo          , Wo          , Wo          , Xu          , Xu          , Xu          , Xu          
Xu          ,Xu          , Xu          , Uu          , Ww          , Ww          , Wo          , Xu          , Xu          , Xu          , Xu          , Wo          , Xu          , Xu          , Xu          , Wo          , Wo          , Xu          , Xu          , Xu          , Xu          , Xu          
Xu          ,Xu          , Xu          , Uu          , Uu          , Ww          , Ww          , Xu          , Wo          , Xu          , Xu          , Xu          , Xu          , Xu          , Xu          , Wo          , Xu          , Xu          , Xu          , Xu          , Xu          , Xu          
Xu          ,Xu          , Xu          , Xu          , Uu          , Ww          , Ww          , Ww          , Ww          , Ww          , Ww          , Xu          , Xu          , Xu          , Xu          , Xu          , Xu          , Xu          , Xu          , Xu          , Xu          , Xu          
Xu          ,Xu          , Xu          , Xu          , Uu          , Ww          , Ww          , Ww          , Ww          , Ww          , Xu          , Xu          , Xu          , Xu          , Xu          , Xu          , Xu          , Xu          , Xu          , Xu          , Xu          , Xu          
Xu          ,Xu          , Xu          , Xu          , Uu          , Ww          , Xu          , Ww          , Xu          , Xu          , Xu          , Xu          , Xu          , Xu          , Xu          , Xu          , Xu          , Xu          , Xu          , Xu          , Xu          , Xu          
Xu          ,Xu          , Xu          , Xu          , Uu          , Xu          , Xu          , Xu          , Xu          , Xu          , Xu          , Xu          , Xu          , Xu          , Xu          , Xu          , Xu          , Xu          , Xu          , Xu          , Xu          , Xu          
Xu          ,Xu          , Uu          , Uu          , Uu          , Xu          , Xu          , Xu          , Xu          , Xu          , Xu          , Xu          , Xu          , Xu          , Xu          , Xu          , Xu          , Xu          , Xu          , Xu          , Xu          , Xu          
Uu          ,Uu          , Uu          , Uu          , Uu          , Xu          , Xu          , Xu          , Xu          , Xu          , Xu          , Xu          , Xu          , Xu          , Xu          , Xu          , Xu          , Xu          , Xu          , Xu          , Xu          , Xu          
Uu          ,Uu          , Uu          , Uu          , Uu          , Xu          , Xu          , Xu          , Xu          , Xu          , Xu          , Xu          , Xu          , Xu          , Xu          , Xu          , Xu          , Xu          , Xu          , Xu          , Xu          , Xu          
